TTTTTTTTTTTTTTTTT
T               T
T R  TTTTTTTTT  T
T  R     R   T  T
T        T   T   .
T        T T    T
T R TTTTT  T   TT
T R T      TTTTTT
T   T           T
T    R    R     T
T  R            T
TTTTTTTTTTTTTTTTT